####################
# ...#             #
# ## # # # # # # # #
# #  # #         # #
# ###  # # # # # # #
#      #           #
# ###### # # # # # #
# #            #   #
# ###### # # # # # #
#                  #
######## # # # # # #
#     $#     #     #
# ###### # # # # # #
#               ...#
####################
